{
  "levels": [
    {
      "id": 1,
      "rows": 5,
      "cols": 6,
      "pattern": [
        [1, 1, 1, 1, 1, 1],
        [1, 0, 0, 0, 0, 1],
        [3, 0, 3, 3, 0, 3],
        [1, 0, 0, 0, 0, 1],
        [1, 1, 0, 0, 1, 1]
      ]
    },
    {
      "id": 2,
      "rows": 9,
      "cols": 8,
      "pattern": [
        [1, 0, 0, 0, 0, 0, 0, 1],
        [1, 0, 0, 0, 0, 0, 0, 1],
        [1, 0, 0, 0, 0, 0, 0, 1],
        [1, 0, 0, 0, 0, 0, 0, 1],
        [1, 0, 0, 0, 0, 0, 0, 1],
        [1, 0, 0, 0, 0, 0, 0, 1],
        [3, 0, 0, 0, 0, 0, 0, 3],
        [2, 2, 2, 2, 2, 2, 2, 2],
        [1, 3, 1, 1, 1, 3, 1, 1]
      ]
    },
    {
      "id": 3,
      "rows": 7,
      "cols": 8,
      "pattern": [
        [1, 2, 1, 2, 1, 2, 1, 2],
        [2, 1, 2, 1, 2, 1, 2, 1],
        [1, 2, 3, 2, 1, 2, 1, 2],
        [2, 1, 2, 1, 2, 1, 2, 1],
        [1, 2, 1, 2, 1, 2, 3, 2],
        [2, 1, 2, 1, 2, 1, 2, 1],
        [1, 2, 1, 2, 1, 2, 1, 2]
      ]
    },
    {
      "id": 4,
      "rows": 8,
      "cols": 9,
      "pattern": [
        [1, 1, 1, 1, 1, 1, 1, 1, 1],
        [1, 0, 0, 0, 0, 0, 0, 0, 1],
        [1, 0, 2, 2, 2, 2, 2, 0, 1],
        [1, 0, 2, 0, 0, 0, 2, 0, 1],
        [1, 0, 2, 0, 1, 0, 2, 0, 1],
        [1, 0, 2, 0, 0, 0, 2, 0, 1],
        [1, 0, 2, 2, 2, 2, 2, 0, 1],
        [1, 0, 0, 0, 0, 0, 0, 0, 1]
      ]
    },
    {
      "id": 5,
      "rows": 6,
      "cols": 8,
      "pattern": [
        [0, 0, 1, 1, 1, 1, 0, 0],
        [0, 2, 1, 1, 1, 1, 2, 0],
        [1, 1, 1, 1, 1, 1, 1, 1],
        [1, 1, 1, 1, 1, 1, 1, 1],
        [0, 2, 1, 1, 1, 1, 2, 0],
        [0, 0, 1, 1, 1, 1, 0, 0]
      ]
    },
    {
      "id": 6,
      "rows": 10,
      "cols": 9,
      "pattern": [
        [1, 1, 1, 1, 1, 1, 1, 1, 1],
        [1, 0, 0, 0, 1, 0, 0, 0, 1],
        [1, 0, 2, 0, 1, 0, 2, 0, 1],
        [1, 0, 2, 0, 2, 0, 2, 0, 1],
        [1, 0, 0, 0, 1, 0, 0, 0, 1],
        [1, 0, 2, 2, 2, 2, 2, 0, 1],
        [1, 0, 0, 0, 1, 0, 0, 0, 1],
        [1, 0, 2, 0, 1, 0, 2, 0, 1],
        [1, 0, 0, 0, 1, 0, 0, 0, 1],
        [1, 1, 1, 1, 1, 1, 1, 1, 1]
      ]
    },
    {
      "id": 7,
      "rows": 8,
      "cols": 6,
      "pattern": [
        [0, 0, 0, 1, 0, 0],
        [0, 0, 1, 1, 1, 0],
        [0, 1, 1, 1, 1, 1],
        [1, 1, 1, 1, 1, 1],
        [1, 1, 2, 2, 1, 1],
        [1, 1, 1, 1, 1, 1],
        [0, 1, 1, 1, 1, 0],
        [0, 0, 1, 1, 0, 0]
      ]
    },
    {
      "id": 8,
      "rows": 10,
      "cols": 9,
      "pattern": [
        [1, 1, 1, 1, 1, 1, 1, 1, 1],
        [1, 0, 0, 0, 1, 0, 0, 0, 1],
        [1, 0, 2, 0, 1, 0, 2, 0, 1],
        [1, 0, 2, 0, 2, 0, 2, 0, 1],
        [1, 0, 0, 0, 1, 0, 0, 0, 1],
        [1, 0, 2, 2, 2, 2, 2, 0, 1],
        [1, 0, 0, 0, 1, 0, 0, 0, 1],
        [1, 0, 2, 0, 1, 0, 2, 0, 1],
        [1, 0, 0, 0, 1, 0, 0, 0, 1],
        [1, 1, 1, 1, 1, 1, 1, 1, 1]
      ]
    }
  ]
}
